NO     textures/bluestone.xpm     			

SO      textures/bluestone.xpm    

WE textures/bluestone.xpm
EA textures/bluestone.xpm

F 220,100,0
C 153,204,255


11111111111111
10000100010001
11000000000001
10000000000001
10000000000001
1000100N000001
11011110111101
11111111111111