NO     textures/bluestone.xpm     			

SO      textures/colorstone.xpm    

WE textures/eagle.xpm
EA textures/simonkraft/wet_sponge.xpm

F 220,100,0
C 153,204,255


11111111111111
10000100010001
11000000000001
10000000000001
10000000000001
10001000000001
1101111N111101
11111111111111