NO ./path_to_the_north_texture.xpm
SO ./path_to_the_south_texture.xpm
WE ./path_to_the_west_texture.xpm
EA ./path_to_the_east_texture.xpm
F 220,100,0
C 225,30,0

11111111111111111111111111111111111111
 111 11000000000110000000000001
11111000001110000000000001111111111111
10010000000000000000000011
1111111110110000011100001      
100000000011000001110111111111111
1111011111111       10111      1
11110111111111011101010010001    
11000000110101011100000010001
10000000000000001100000010001
1000000000000000110101001000111
11000001110101011111011110N000111
11110111 1110101 1011110100001   1
11111111 1111111 1111111111111