NO textures/simonkraft/wet_sponge.xpm  
SO textures/simonkraft/wet_sponge.xpm  
WE textures/simonkraft/wet_sponge.xpm
EA textures/simonkraft/wet_sponge.xpm

F 220,100,0
C 153,204,255

1111111111
110000111 
1100101111
110N010111
1110001011
1111111111